{
  "name": "GMMK Pro",
  "vendorProductId": 839864388,
  "macros": ["", "", "", "", "", "", "", "", "", "", "", "", "", "", "", ""],
  "layers": [
    [
      "KC_LSFT",
      "KC_MUTE",
      "KC_NO",
      "KC_LEFT",
      "MO(2)",
      "KC_RGHT",
      "KC_LCTL",
      "KC_F5",
      "KC_Q",
      "KC_TAB",
      "KC_A",
      "KC_ESC",
      "KC_Z",
      "KC_PGDN",
      "KC_GRV",
      "KC_1",
      "KC_W",
      "KC_LCTL",
      "KC_S",
      "KC_NO",
      "KC_X",
      "KC_HOME",
      "KC_F1",
      "KC_2",
      "KC_E",
      "KC_F3",
      "KC_D",
      "KC_F4",
      "KC_C",
      "KC_UP",
      "KC_F2",
      "KC_3",
      "KC_R",
      "KC_T",
      "KC_F",
      "KC_G",
      "KC_V",
      "KC_B",
      "KC_5",
      "KC_4",
      "KC_U",
      "KC_Y",
      "KC_J",
      "KC_H",
      "KC_M",
      "KC_N",
      "KC_6",
      "KC_7",
      "KC_I",
      "KC_RBRC",
      "KC_K",
      "KC_F6",
      "KC_COMM",
      "KC_PGUP",
      "KC_EQL",
      "KC_8",
      "KC_O",
      "KC_F7",
      "KC_L",
      "KC_DOWN",
      "KC_DOT",
      "KC_END",
      "KC_F8",
      "KC_9",
      "KC_P",
      "KC_LBRC",
      "KC_SCLN",
      "KC_QUOT",
      "KC_NO",
      "KC_SLSH",
      "KC_MINS",
      "KC_0",
      "KC_LALT",
      "KC_RSFT",
      "MO(1)",
      "KC_LGUI",
      "KC_SPC",
      "KC_RGUI",
      "KC_NO",
      "KC_DEL",
      "KC_NO",
      "KC_BSPC",
      "KC_BSLS",
      "KC_F11",
      "KC_ENT",
      "KC_F12",
      "KC_F9",
      "KC_F10"
    ],
    [
      "KC_TRNS",
      "RGB_TOG",
      "KC_NO",
      "KC_TRNS",
      "KC_TRNS",
      "KC_TRNS",
      "KC_RCTL",
      "KC_TRNS",
      "KC_TRNS",
      "KC_TRNS",
      "KC_TRNS",
      "KC_SLEP",
      "KC_TRNS",
      "KC_TRNS",
      "KC_TRNS",
      "KC_TRNS",
      "KC_TRNS",
      "KC_RCTL",
      "KC_TRNS",
      "KC_NO",
      "KC_TRNS",
      "KC_TRNS",
      "KC_TRNS",
      "KC_TRNS",
      "KC_TRNS",
      "KC_TRNS",
      "KC_TRNS",
      "KC_TRNS",
      "KC_TRNS",
      "KC_TRNS",
      "KC_TRNS",
      "KC_TRNS",
      "KC_TRNS",
      "KC_TRNS",
      "KC_TRNS",
      "KC_TRNS",
      "KC_TRNS",
      "KC_TRNS",
      "KC_TRNS",
      "KC_TRNS",
      "KC_TRNS",
      "KC_TRNS",
      "KC_TRNS",
      "KC_TRNS",
      "KC_TRNS",
      "KC_TRNS",
      "KC_TRNS",
      "KC_TRNS",
      "KC_TRNS",
      "KC_TRNS",
      "KC_TRNS",
      "KC_TRNS",
      "KC_TRNS",
      "KC_TRNS",
      "KC_TRNS",
      "KC_TRNS",
      "KC_TRNS",
      "KC_TRNS",
      "KC_TRNS",
      "KC_TRNS",
      "KC_TRNS",
      "KC_TRNS",
      "KC_TRNS",
      "KC_TRNS",
      "KC_TRNS",
      "KC_TRNS",
      "KC_TRNS",
      "KC_TRNS",
      "KC_NO",
      "KC_TRNS",
      "KC_TRNS",
      "KC_TRNS",
      "KC_RALT",
      "KC_TRNS",
      "KC_TRNS",
      "KC_RGUI",
      "KC_TRNS",
      "KC_TRNS",
      "KC_NO",
      "KC_TRNS",
      "KC_NO",
      "KC_DEL",
      "KC_TRNS",
      "KC_TRNS",
      "KC_TRNS",
      "KC_TRNS",
      "KC_TRNS",
      "KC_TRNS"
    ],
    [
      "KC_TRNS",
      "KC_TRNS",
      "KC_NO",
      "KC_TRNS",
      "KC_TRNS",
      "KC_TRNS",
      "KC_TRNS",
      "KC_TRNS",
      "KC_TRNS",
      "KC_TRNS",
      "KC_TRNS",
      "KC_TRNS",
      "KC_TRNS",
      "KC_TRNS",
      "KC_TRNS",
      "KC_P1",
      "KC_TRNS",
      "KC_CAPS",
      "KC_TRNS",
      "KC_NO",
      "KC_TRNS",
      "KC_TRNS",
      "KC_TRNS",
      "KC_P2",
      "KC_TRNS",
      "KC_TRNS",
      "KC_TRNS",
      "KC_TRNS",
      "KC_TRNS",
      "KC_TRNS",
      "KC_TRNS",
      "KC_P3",
      "KC_TRNS",
      "KC_TRNS",
      "KC_TRNS",
      "KC_TRNS",
      "KC_TRNS",
      "KC_TRNS",
      "KC_P5",
      "KC_P4",
      "KC_P4",
      "KC_TRNS",
      "KC_P1",
      "KC_TRNS",
      "KC_P0",
      "KC_TRNS",
      "KC_P6",
      "KC_P7",
      "KC_P5",
      "KC_PAST",
      "KC_P2",
      "KC_TRNS",
      "KC_P0",
      "KC_TRNS",
      "KC_PPLS",
      "KC_P8",
      "KC_P6",
      "KC_TRNS",
      "KC_P3",
      "KC_TRNS",
      "KC_PDOT",
      "KC_TRNS",
      "KC_TRNS",
      "KC_P9",
      "KC_TRNS",
      "KC_PSLS",
      "KC_TRNS",
      "KC_TRNS",
      "KC_NO",
      "KC_TRNS",
      "KC_PMNS",
      "KC_P0",
      "KC_TRNS",
      "KC_TRNS",
      "KC_TRNS",
      "KC_TRNS",
      "KC_TRNS",
      "KC_TRNS",
      "KC_NO",
      "KC_INS",
      "KC_NO",
      "KC_NLCK",
      "KC_TRNS",
      "KC_SLCK",
      "KC_PENT",
      "KC_PAUS",
      "KC_TRNS",
      "KC_PSCR"
    ],
    [
      "KC_TRNS",
      "KC_TRNS",
      "KC_NO",
      "KC_TRNS",
      "KC_TRNS",
      "KC_TRNS",
      "KC_TRNS",
      "KC_TRNS",
      "KC_TRNS",
      "KC_TRNS",
      "KC_TRNS",
      "KC_TRNS",
      "KC_TRNS",
      "KC_TRNS",
      "KC_TRNS",
      "KC_TRNS",
      "KC_TRNS",
      "KC_TRNS",
      "KC_TRNS",
      "KC_NO",
      "KC_TRNS",
      "KC_TRNS",
      "KC_TRNS",
      "KC_TRNS",
      "KC_TRNS",
      "KC_TRNS",
      "KC_TRNS",
      "KC_TRNS",
      "KC_TRNS",
      "KC_TRNS",
      "KC_TRNS",
      "KC_TRNS",
      "KC_TRNS",
      "KC_TRNS",
      "KC_TRNS",
      "KC_TRNS",
      "KC_TRNS",
      "KC_TRNS",
      "KC_TRNS",
      "KC_TRNS",
      "KC_TRNS",
      "KC_TRNS",
      "KC_TRNS",
      "KC_TRNS",
      "KC_TRNS",
      "KC_TRNS",
      "KC_TRNS",
      "KC_TRNS",
      "KC_TRNS",
      "KC_TRNS",
      "KC_TRNS",
      "KC_TRNS",
      "KC_TRNS",
      "KC_TRNS",
      "KC_TRNS",
      "KC_TRNS",
      "KC_TRNS",
      "KC_TRNS",
      "KC_TRNS",
      "KC_TRNS",
      "KC_TRNS",
      "KC_TRNS",
      "KC_TRNS",
      "KC_TRNS",
      "KC_TRNS",
      "KC_TRNS",
      "KC_TRNS",
      "KC_TRNS",
      "KC_NO",
      "KC_TRNS",
      "KC_TRNS",
      "KC_TRNS",
      "KC_TRNS",
      "KC_TRNS",
      "KC_TRNS",
      "KC_TRNS",
      "KC_TRNS",
      "KC_TRNS",
      "KC_NO",
      "KC_TRNS",
      "KC_NO",
      "KC_TRNS",
      "KC_TRNS",
      "KC_TRNS",
      "KC_TRNS",
      "KC_TRNS",
      "KC_TRNS",
      "KC_TRNS"
    ]
  ],
  "encoders": [
    [
      ["KC_VOLD", "KC_VOLU"],
      ["RGB_VAD", "RGB_VAI"],
      ["KC_TRNS", "KC_TRNS"],
      ["KC_TRNS", "KC_TRNS"]
    ]
  ]
}
